%%%%%%
% P  %
% ...%
%. G %
%%%%%%
