%%%%%%%%%%%%%%%%%%%
%....%.......%....%
%.%%.%.%%%%%.%.%%.%
%.%.............%.%
%.%.%%.%%.%%.%%.%.%
%......%G G%......%
%.%.%%.%%.%%.%%.%.%
%.%.............%.%
%.%%.%.%%%%%.%.%%.%
%....%...P...%....%
%%%%%%%%%%%%%%%%%%%
