%%%%%%%%%%%%%%%%%%%
%%%%.....%.....%%%%
%....%%%.P.%%%....%
%G%%G..%%.%%...%%.%
%.%..%...G...%..%.%
%.%%.%.%%%%%.%.%%.%
%.................%
%%%%%%%%%%%%%%%%%%%
