%%%%%%%%%%%%%%%%%%%%%%%%%%%%%
%                           %
% %%%% %%%%% %%%%%% % % % % %
%                   % % % % %
% %%%% %%%%% %%%%%% % % % % %
%                           %
% % % % %.%%%%%%% % % % % % %
% % % %           % % % % % %
% % % % %%%%%...% % % . % % %
%                 % % %G% % %
% % % % %% %%%.%% % % % % % %
% % . %   PG     G          %
% % % % %% %%%%%% %%% %%%%% %
%                           %
%%%.%%%%%%%%%%%%%%%%%%%.%%%%%
